30
1 0 32 256 16 0 -1
1 0 216 256 8 0 -1
1 0 208 16 16 0 -1
1 0 192 16 16 0 -1
1 0 176 16 16 0 -1
1 0 160 16 16 0 -1
1 0 144 16 16 0 -1
1 0 128 16 16 0 -1
1 0 112 16 16 0 -1
1 0 96 16 16 0 -1
1 0 80 16 16 0 -1
1 0 64 16 16 0 -1
1 0 48 16 16 0 -1
1 240 208 16 16 0 -1
1 240 192 16 16 0 -1
1 240 176 16 16 0 -1
1 240 160 16 16 0 -1
1 240 144 16 16 0 -1
1 240 128 16 16 0 -1
1 240 112 16 16 0 -1
1 240 96 16 16 0 -1
1 240 80 16 16 0 -1
1 240 64 16 16 0 -1
1 240 48 16 16 0 -1
1 64 144 128 16 0 -1
1 64 128 32 32 0 -1
1 160 128 32 32 0 -1
3 192 112 48 8 0 -1
3 16 112 48 8 0 -1
6 48 80 32 48 0 -1

