35 16 14
0 1 1 1 1 1 1 1 1 1 1 1 1 1 1 2
3 4 5 5 5 5 5 4 5 5 5 5 5 5 4 6
3 7 8 8 8 8 8 7 9 10 8 8 9 10 7 6
3 11 8 8 9 10 8 11 12 12 10 9 12 12 11 6
3 13 10 9 12 12 10 11 12 12 12 12 12 12 11 6
3 13 12 12 14 15 15 15 15 15 15 16 12 12 13 6
3 13 12 12 6 3 17 4 17 17 6 3 12 12 13 6
3 18 19 20 21 22 12 11 12 12 21 22 18 19 20 6
3 4 17 17 17 17 12 11 12 12 17 17 17 17 4 6
3 13 12 23 24 12 25 11 12 12 12 12 12 12 13 6
3 7 12 26 27 12 10 7 12 12 12 12 12 12 7 6
3 7 28 29 30 31 32 7 32 31 32 32 31 25 7 6
22 14 33 15 15 15 15 15 15 15 15 33 15 15 16 21
6 34 34 34 34 34 34 34 34 34 34 34 34 34 34 3
