31 16 14
0 1 1 1 1 1 1 1 1 1 1 1 1 1 1 2
3 4 5 5 5 5 5 4 5 5 5 5 5 5 4 6
3 7 5 5 5 5 5 7 8 9 5 5 8 9 7 6
3 10 5 5 8 9 5 10 5 5 9 8 5 5 10 6
3 11 9 8 5 5 9 10 5 5 5 5 5 5 10 6
3 11 5 5 12 13 13 13 13 13 13 14 5 5 11 6
3 11 5 5 6 3 5 4 5 5 6 3 5 5 11 6
3 15 16 17 18 19 5 10 5 5 18 19 15 16 17 6
3 4 5 5 5 5 5 10 5 5 5 5 5 5 4 6
3 11 5 20 21 5 22 10 5 5 5 5 5 5 11 6
3 7 5 23 24 5 9 7 5 5 5 5 5 5 7 6
3 7 25 26 27 28 28 7 28 28 28 28 28 22 7 6
19 12 29 13 13 13 13 13 13 13 13 29 13 13 14 18
6 30 30 30 30 30 30 30 30 30 30 30 30 30 30 3
