34 16 14
0 1 1 1 1 1 1 1 1 1 1 1 1 1 1 2
3 4 5 6 6 4 5 6 6 5 4 6 6 5 4 7
3 4 8 9 9 4 10 9 9 10 4 9 9 8 4 7
3 11 10 4 4 4 10 4 4 8 4 4 4 10 4 7
3 12 13 12 12 12 13 12 12 13 12 12 12 13 12 7
3 4 8 14 15 4 8 14 15 8 4 14 15 8 4 7
3 4 8 4 4 4 8 4 4 10 4 4 4 10 4 7
3 16 10 12 12 12 10 12 12 10 12 12 12 10 12 7
3 4 10 4 4 4 8 4 4 10 4 4 4 8 4 7
3 4 13 17 18 4 13 4 4 13 4 4 4 13 4 7
3 19 20 21 22 19 20 12 12 19 20 12 23 19 20 7
3 24 25 26 27 24 25 16 12 24 25 23 4 24 25 7
28 29 30 31 31 29 30 31 31 29 30 31 31 29 30 32
7 33 33 33 33 33 33 33 33 33 33 33 33 33 33 3
