39 16 14
0 0 0 0 0 0 0 0 0 0 0 0 0 0 0 1
2 3 4 5 5 6 4 5 5 4 6 5 5 4 6 7
2 8 9 10 10 11 12 10 10 12 11 10 10 9 11 7
2 13 12 11 11 11 12 11 11 9 11 11 11 12 11 7
2 14 15 14 16 16 15 16 14 15 16 16 14 15 14 7
2 17 9 18 19 11 9 18 19 9 17 18 19 9 17 7
2 11 9 6 6 11 9 6 6 12 11 6 6 12 11 7
2 20 12 16 16 16 12 16 16 12 16 14 14 12 16 7
2 8 12 11 17 21 9 17 11 12 11 11 11 9 17 7
2 8 15 22 23 11 15 11 11 15 11 11 11 15 11 7
2 24 25 26 27 24 25 16 16 24 25 16 28 24 25 7
2 29 30 31 32 29 30 20 16 29 30 28 8 29 30 7
33 34 35 36 36 34 35 36 36 34 35 36 36 34 35 37
7 38 38 38 38 38 38 38 38 38 38 38 38 38 38 2
