30
0 48 144 32 16 0 -1
0 112 144 32 16 0 -1
0 176 144 32 16 0 -1
1 0 216 256 8 0 -1
1 0 208 16 16 0 -1
1 0 192 16 16 0 -1
1 0 176 16 16 0 -1
1 0 160 16 16 0 -1
1 0 144 16 16 0 -1
1 0 128 16 16 0 -1
1 0 112 16 16 0 -1
1 0 96 16 16 0 -1
1 0 80 16 16 0 -1
1 0 64 16 16 0 -1
1 0 48 16 16 0 -1
1 0 32 256 16 0 -1
1 16 64 32 32 0 -1
1 80 64 32 32 0 -1
1 144 64 32 32 0 -1
1 208 64 32 32 0 -1
1 240 208 16 16 0 -1
1 240 192 16 16 0 -1
1 240 176 16 16 0 -1
1 240 160 16 16 0 -1
1 240 144 16 16 0 -1
1 240 128 16 16 0 -1
1 240 112 16 16 0 -1
1 240 96 16 16 0 -1
1 240 80 16 16 0 -1
6 48 80 32 48 0 -1
