81 64 59
0 1 1 1 1 1 1 1 0 1 1 1 1 1 1 1 0 1 1 1 2 3 2 3 0 1 1 1 1 1 1 1 0 1 1 1 1 1 1 1 0 1 1 1 1 1 1 1 0 1 1 1 1 1 1 1 0 1 1 1 1 1 1 1
4 5 5 5 5 6 7 5 4 7 5 5 5 5 6 8 4 5 5 5 9 10 9 10 4 7 5 5 6 7 6 11 4 5 5 5 12 13 11 14 4 7 5 5 5 5 6 8 4 5 5 5 5 6 7 5 4 7 5 5 5 5 6 8
4 7 15 15 6 13 13 7 16 13 7 6 7 6 13 13 16 17 15 15 18 19 18 19 16 13 7 6 13 13 13 13 16 7 15 15 6 13 14 15 16 13 7 6 7 6 13 13 4 7 15 15 6 13 13 7 16 13 7 6 7 6 13 13
16 13 7 6 13 13 13 13 16 13 13 13 13 13 13 13 16 20 7 6 9 10 9 10 16 13 13 13 13 13 13 13 16 13 7 6 13 13 21 15 4 13 13 13 13 13 13 13 16 13 7 6 13 13 13 13 16 13 13 13 13 13 13 13
16 13 13 13 13 22 23 24 16 13 13 13 13 13 13 13 16 13 22 23 25 26 25 26 4 13 13 13 13 27 28 13 4 13 13 13 13 13 13 7 16 13 13 13 13 13 13 13 16 13 13 13 13 22 23 24 16 13 13 13 13 13 13 13
16 29 30 29 30 31 32 33 4 29 30 30 30 30 30 29 4 13 20 20 20 20 20 20 4 13 13 13 13 20 20 13 4 29 30 30 30 29 30 30 4 29 30 30 30 30 29 30 16 29 30 29 30 31 32 33 4 29 30 30 30 30 30 29
4 13 8 8 11 7 5 5 4 11 27 34 34 28 8 14 4 29 30 30 30 30 29 30 4 29 30 30 30 29 30 30 22 35 23 23 24 23 23 24 4 11 36 37 36 37 8 14 4 13 8 8 11 7 5 5 4 11 27 34 34 28 8 14
4 13 13 13 13 13 7 6 4 13 20 20 20 20 14 15 16 11 8 8 8 8 11 11 16 8 11 8 8 8 14 15 38 20 20 20 20 20 20 20 4 13 20 20 20 20 14 15 4 13 13 13 13 13 7 6 4 13 20 20 20 20 14 15
16 13 13 13 13 13 13 14 4 13 13 13 13 13 39 15 16 13 13 13 13 13 13 13 16 13 13 13 13 13 7 15 16 13 13 40 40 13 13 14 4 13 13 13 13 13 7 15 16 13 13 13 13 13 13 14 4 13 13 13 13 13 7 15
0 13 13 13 13 13 13 7 16 13 13 13 13 13 13 7 2 3 2 3 13 13 13 2 3 13 13 2 3 13 13 7 0 13 13 40 40 13 13 7 0 13 13 13 13 13 13 7 0 13 13 13 13 13 13 7 16 13 13 13 13 13 13 7
0 29 30 30 30 30 29 30 4 30 30 30 30 30 29 30 9 10 9 10 41 41 29 42 10 29 30 9 10 29 30 30 0 29 30 40 40 30 29 30 0 29 30 29 30 30 29 30 0 29 30 30 30 30 29 30 4 30 30 30 30 30 29 30
22 35 23 24 8 8 13 11 4 8 11 8 13 22 35 24 25 26 25 26 23 23 23 25 26 23 23 25 26 23 23 24 22 23 43 23 23 43 23 23 35 23 23 23 35 23 23 24 22 35 23 24 8 8 13 11 4 8 11 8 13 22 35 24
44 45 45 46 36 37 13 13 0 13 13 36 37 44 45 46 44 45 45 45 45 45 45 45 45 45 45 45 45 45 45 46 44 45 45 45 45 45 45 45 45 45 45 45 45 45 45 46 44 45 45 46 36 37 13 13 0 13 13 36 37 44 45 46
31 32 32 33 20 20 13 13 0 13 13 20 20 31 32 33 31 32 32 32 32 32 32 32 32 32 32 32 32 32 32 33 31 32 32 32 32 32 32 32 32 32 32 32 32 32 32 33 31 32 32 33 20 20 13 13 0 13 13 20 20 31 32 33
0 47 47 47 47 47 47 47 0 47 47 47 47 47 47 47 22 23 23 35 23 23 23 23 35 23 23 23 23 35 23 24 0 47 47 47 47 47 47 47 0 47 47 47 47 47 47 47 0 47 47 47 47 47 47 47 0 47 47 47 47 47 47 47
0 1 1 1 1 1 1 1 0 1 1 1 1 1 1 1 44 45 45 45 45 45 45 45 45 45 45 45 45 45 45 48 0 1 1 1 1 1 1 1 0 1 1 1 1 1 1 1 0 1 1 1 1 1 1 1 0 1 1 1 1 1 1 1
4 5 5 5 5 5 5 5 4 7 5 5 5 5 6 13 49 50 50 50 50 50 50 50 50 50 50 50 50 50 50 51 4 5 5 5 5 5 5 5 4 7 5 5 5 5 6 13 4 6 7 5 5 5 5 5 4 7 5 5 5 5 6 11
4 7 15 15 6 7 15 15 4 13 7 6 7 6 13 13 49 50 50 50 50 50 50 50 50 50 50 50 50 50 50 51 4 7 15 15 6 7 15 15 4 13 7 6 7 6 13 13 16 13 13 7 6 7 15 15 16 13 7 6 7 6 13 13
16 13 7 6 13 13 7 15 16 13 13 13 13 13 13 13 44 45 45 45 45 45 45 45 45 45 45 45 45 45 45 46 16 13 7 6 13 13 7 15 16 13 13 13 13 13 13 13 16 13 13 13 13 13 36 37 36 37 13 13 13 13 13 13
16 13 13 13 13 13 13 7 16 13 13 13 13 13 13 13 49 50 50 50 50 50 50 50 50 50 50 50 50 50 50 51 16 13 13 13 13 13 13 7 4 13 13 13 13 13 13 13 4 13 13 13 13 13 20 20 16 20 13 13 13 13 13 13
16 30 30 30 29 30 30 30 52 30 30 30 30 30 29 30 49 50 50 50 50 50 50 50 50 50 50 50 50 50 50 51 16 30 30 30 29 30 30 30 4 30 30 30 30 30 29 30 4 29 30 30 29 30 29 30 16 29 29 30 30 29 30 29
4 13 8 8 13 13 8 7 4 13 8 11 13 8 13 14 49 50 50 50 50 50 50 50 50 50 50 50 50 50 50 51 4 13 8 8 13 13 8 7 4 13 8 11 13 8 13 14 4 53 54 55 8 11 8 7 16 11 8 11 53 54 55 8
4 13 13 13 13 13 13 13 4 13 13 13 13 13 14 15 49 50 50 50 50 50 50 50 50 50 50 50 50 50 50 51 4 13 13 13 13 13 13 13 4 13 13 13 13 13 14 15 4 20 20 20 13 27 28 13 16 27 28 13 20 20 20 13
16 13 13 13 13 13 13 14 16 13 13 13 13 13 7 15 49 50 50 50 50 50 50 50 50 50 50 50 50 50 50 51 16 13 13 13 13 13 13 14 16 13 13 13 13 13 7 15 16 13 13 13 13 20 20 13 4 20 20 13 13 13 13 13
4 13 13 13 13 13 13 7 16 13 13 13 13 13 13 7 44 45 45 45 45 45 45 45 45 45 45 45 45 45 45 46 4 13 13 13 13 13 13 7 16 13 13 13 13 13 13 7 0 13 13 13 13 13 13 13 16 13 13 13 13 13 13 13
4 29 30 30 30 29 30 30 4 30 30 30 30 29 30 30 49 50 50 50 50 50 50 50 50 50 50 50 50 50 50 51 4 29 30 30 30 29 30 30 4 30 30 30 30 29 30 30 0 30 30 30 30 30 30 30 0 30 30 30 30 30 30 29
16 6 8 13 11 13 13 13 4 11 8 13 13 13 13 7 49 50 50 50 50 50 50 50 50 50 50 50 50 50 50 51 16 6 8 13 11 13 13 13 56 57 8 13 13 13 13 7 22 58 59 59 59 59 59 59 59 59 59 59 59 59 60 24
0 13 13 13 13 13 13 13 0 13 13 13 13 13 13 13 49 50 50 50 50 50 50 50 50 50 50 50 50 50 50 51 0 13 13 13 13 13 13 13 0 13 13 13 13 13 13 13 44 45 45 45 46 45 45 45 45 44 45 45 45 45 45 46
0 13 13 13 13 13 13 13 0 13 13 13 13 13 13 13 31 32 32 32 32 32 32 32 32 32 32 32 32 32 32 33 0 13 13 13 13 13 13 13 0 13 13 13 13 13 13 13 31 32 32 32 33 32 32 32 32 31 32 32 32 32 32 33
22 23 23 35 47 47 47 47 0 47 47 47 47 47 47 47 0 47 47 47 47 47 47 47 0 47 47 47 47 47 47 47 0 47 47 47 47 47 47 47 0 47 47 47 47 47 47 47 0 47 47 47 47 47 47 47 0 47 47 47 47 47 47 47
44 45 45 46 1 1 1 1 0 1 1 1 1 1 1 1 0 1 1 1 1 1 1 1 0 1 1 1 1 1 1 1 0 1 1 1 1 1 1 1 0 1 1 1 1 1 1 1 0 1 1 1 1 1 1 1 0 1 1 1 1 1 1 1
49 50 50 51 5 5 5 5 4 7 5 5 5 12 13 11 4 5 5 5 5 5 5 5 4 7 5 5 5 5 6 13 4 5 5 5 5 5 5 5 4 7 5 5 5 5 6 13 4 5 5 5 5 5 5 5 4 5 6 7 5 5 6 11
49 50 50 51 27 34 34 34 34 28 7 6 7 6 13 13 16 7 15 15 6 7 15 6 16 13 7 6 7 6 13 13 4 7 15 15 6 7 15 15 4 13 7 6 7 6 13 13 16 7 15 15 6 7 15 15 16 6 13 13 7 6 13 13
44 45 45 46 20 20 20 20 38 20 13 13 13 13 13 13 16 13 7 6 13 36 37 13 16 13 13 13 13 13 13 13 16 13 7 6 13 13 7 15 4 13 13 13 13 13 13 13 16 13 7 6 13 13 7 6 16 13 13 13 13 13 13 13
49 50 50 51 13 13 13 14 4 13 13 13 13 13 22 24 4 13 13 13 13 20 20 13 4 30 22 24 29 30 30 30 16 13 13 13 13 13 13 7 4 13 13 13 13 13 13 13 16 29 22 24 29 30 30 22 24 29 30 29 22 24 29 30
49 50 50 51 29 30 14 15 4 29 30 29 30 29 44 46 0 11 8 11 8 8 11 8 16 11 44 46 8 11 11 8 16 30 30 30 29 30 30 30 4 30 30 30 30 30 29 30 4 8 44 46 11 8 11 44 46 8 11 8 44 46 8 11
31 32 32 33 11 13 8 11 4 11 27 34 34 28 31 33 22 23 24 29 29 29 29 29 16 29 31 32 22 23 23 24 4 13 8 8 13 13 8 7 4 13 8 11 13 8 13 14 22 35 31 33 22 23 24 31 33 22 23 24 31 33 23 24
38 20 20 20 13 27 28 13 16 13 20 20 20 20 20 20 44 45 46 8 11 8 11 14 4 8 20 20 20 20 20 20 4 13 13 13 13 13 13 13 4 13 13 13 13 13 14 15 38 20 20 20 20 20 20 20 38 20 20 20 20 20 20 20
4 13 13 13 13 20 20 14 16 13 13 13 13 13 13 14 49 50 51 29 14 12 14 61 16 12 29 29 30 29 30 29 16 13 13 13 13 13 13 14 16 13 13 13 13 13 7 15 16 13 13 40 40 13 13 14 16 12 14 12 13 13 13 13
16 13 13 13 13 13 13 7 4 13 13 13 13 13 14 15 49 50 51 14 15 15 61 40 16 6 8 11 13 13 8 14 4 13 13 13 13 13 13 7 16 13 13 13 13 13 13 7 0 13 13 40 40 13 13 7 0 15 15 15 12 13 13 13
4 29 30 30 29 29 30 30 4 29 29 30 29 14 15 15 49 50 51 15 15 61 40 40 0 29 30 29 29 29 14 61 4 29 30 30 30 29 30 30 4 30 30 30 30 29 30 30 0 29 30 40 40 30 29 30 0 15 15 15 15 12 30 29
22 24 11 8 11 8 13 11 16 11 8 13 11 8 11 22 49 50 51 22 23 35 23 62 63 23 35 23 23 62 63 24 16 6 8 13 11 13 13 13 4 11 8 13 13 13 13 7 22 23 43 23 23 43 23 23 35 23 23 23 23 35 23 24
44 45 22 24 13 13 13 13 0 13 13 13 13 22 24 46 44 45 45 45 45 45 45 45 45 45 45 45 45 45 45 46 0 13 13 13 13 13 13 13 0 13 13 13 13 13 13 13 44 45 45 45 45 45 45 45 45 45 45 45 45 45 45 46
31 32 32 33 13 13 13 13 0 13 13 13 13 31 32 33 31 32 32 32 32 32 32 32 32 32 32 32 32 32 32 33 0 13 13 13 13 13 13 13 0 13 13 13 13 13 13 13 31 32 32 32 32 32 32 32 32 32 32 32 32 32 32 64
0 65 65 65 65 66 47 47 0 47 47 47 47 47 47 47 22 23 23 23 23 23 23 23 23 23 23 23 23 23 23 24 0 47 47 47 47 47 47 47 0 47 47 47 47 47 47 47 22 23 23 35 23 23 44 45 45 45 46 23 35 23 23 24
0 5 5 12 11 13 14 5 0 5 5 5 5 5 5 6 44 45 45 45 45 45 45 45 45 45 45 45 45 45 45 46 0 1 1 1 1 1 1 1 0 1 1 1 1 1 1 1 0 1 1 1 1 1 44 45 45 45 46 1 1 1 67 68
4 15 15 15 12 14 15 15 4 7 15 15 15 15 6 13 31 32 32 32 32 32 32 32 32 32 32 32 32 32 32 33 4 6 7 5 5 5 5 5 16 7 5 5 5 5 6 11 16 5 5 5 5 5 44 45 45 45 46 5 5 5 68 69
16 7 15 15 6 7 15 15 4 13 7 6 7 6 13 13 49 50 50 50 50 51 5 5 5 5 49 50 50 50 50 51 4 13 13 7 6 7 15 15 16 13 7 6 7 6 13 13 4 7 15 15 6 7 44 45 45 45 46 6 7 6 67 70
4 13 7 6 13 13 7 15 16 13 13 13 13 13 13 13 49 50 50 50 50 51 7 15 6 7 49 50 50 50 50 51 4 13 13 13 13 13 22 23 23 23 24 13 13 13 13 13 4 13 7 6 13 13 44 45 45 45 46 13 13 13 68 69
4 13 13 13 13 13 13 7 4 13 13 13 13 13 13 13 49 50 50 50 50 51 27 34 34 28 49 50 50 50 50 51 22 23 23 24 13 13 31 32 32 32 33 13 13 13 13 13 16 30 29 30 30 29 44 45 45 45 46 29 29 30 67 68
4 29 30 30 30 29 30 30 4 30 30 29 30 29 29 30 49 50 50 50 50 51 20 20 20 20 49 50 50 50 50 51 44 45 45 46 13 13 20 20 38 20 20 13 13 13 13 13 4 29 22 24 29 30 44 45 45 45 46 30 30 29 68 69
16 13 8 11 8 8 11 7 4 13 13 8 11 8 8 14 31 32 32 32 32 33 13 13 13 13 31 32 32 32 32 33 31 32 32 33 29 30 30 29 4 29 30 30 29 22 23 24 16 11 44 46 8 11 44 45 45 45 46 11 8 8 67 70
16 13 13 13 13 13 13 13 4 13 13 13 13 13 14 15 38 5 5 5 5 5 12 13 13 13 20 20 20 20 20 20 38 20 20 20 8 8 8 7 16 8 13 13 8 20 20 20 16 13 44 46 13 13 31 32 32 32 33 13 13 14 68 69
4 13 13 13 13 13 13 14 16 13 13 13 13 13 7 15 16 15 15 15 15 15 6 13 14 12 13 13 13 13 13 13 16 13 13 13 13 13 13 13 4 13 13 13 13 13 13 14 16 13 44 46 13 13 20 20 38 5 5 12 14 61 71 72
0 13 13 13 13 13 13 7 0 13 13 13 13 13 13 7 0 15 15 15 15 6 13 14 15 73 12 13 13 13 13 14 0 13 13 13 13 13 13 13 0 13 13 13 13 13 14 15 0 13 44 46 13 74 75 13 0 15 15 15 61 40 76 77
0 30 30 29 30 29 30 30 0 29 30 30 30 29 30 30 0 15 15 15 15 12 14 15 15 15 15 12 29 30 14 15 0 29 29 30 30 29 30 29 0 29 30 30 30 14 15 15 0 29 44 46 29 30 30 29 0 7 15 61 40 40 76 77
22 23 23 35 23 23 23 23 35 23 23 62 63 35 23 24 22 23 23 23 23 23 23 23 23 23 23 23 23 23 23 24 22 23 23 23 23 23 23 23 23 23 23 62 63 23 23 24 22 23 44 46 23 35 43 43 43 43 43 23 23 23 23 24
44 45 45 45 45 45 45 45 45 45 45 45 45 45 45 46 44 45 45 45 45 45 45 45 45 45 45 45 45 45 45 46 44 45 45 45 45 45 45 45 45 45 45 45 45 45 45 46 44 45 45 45 45 45 45 46 45 45 45 45 45 45 45 46
78 79 79 79 79 79 79 79 79 79 79 79 79 79 79 80 78 79 79 79 79 79 79 79 79 79 79 79 79 79 79 80 78 79 79 79 79 79 79 79 79 79 79 79 79 79 79 80 78 79 79 79 79 79 79 80 79 79 79 79 79 79 79 80
