79
0 864 656 64 8 0 -1
0 832 752 32 8 0 -1
0 944 752 32 8 0 -1
0 672 848 64 8 0 -1
0 64 752 32 8 0 -1
0 176 752 32 8 0 -1
0 336 416 32 8 0 -1
1 80 880 48 32 0 -1
1 0 768 64 16 0 -1
1 0 752 64 32 0 -1
1 0 480 64 24 0 -1
1 0 456 64 48 0 -1
1 0 408 64 56 0 -1
1 0 288 32 16 0 -1
1 0 272 64 32 0 -1
1 208 768 624 48 0 -1
1 256 800 64 32 0 -1
1 368 800 32 32 0 -1
1 432 800 32 32 0 -1
1 288 880 96 16 0 -1
1 320 944 64 64 0 -1
1 512 848 128 16 0 -1
1 848 880 48 32 0 -1
1 256 720 256 72 0 -1
1 256 648 256 88 0 -1
1 256 560 256 80 0 -1
1 976 768 48 48 0 -1
1 784 608 48 16 0 -1
1 960 608 48 16 0 -1
1 768 528 24 16 0 -1
1 1000 528 24 16 0 -1
1 768 512 256 32 0 -1
1 800 400 32 32 0 -1
1 768 368 256 16 0 -1
1 880 400 32 32 0 -1
1 960 400 32 32 0 -1
1 768 288 256 24 0 -1
1 768 264 256 24 0 -1
1 768 240 256 16 0 -1
1 864 224 80 24 0 -1
1 864 200 80 24 0 -1
1 864 176 80 24 0 -1
1 864 152 80 24 0 -1
1 864 128 80 32 0 -1
1 800 144 32 16 0 -1
1 800 128 32 16 0 -1
1 800 112 32 16 0 -1
1 800 96 32 16 0 -1
1 800 80 32 16 0 -1
1 800 64 32 16 0 -1
1 720 128 48 16 0 -1
1 608 176 80 32 0 -1
1 224 400 32 32 0 -1
1 224 368 80 16 0 -1
1 256 352 48 24 0 -1
1 256 328 48 24 0 -1
1 256 304 48 16 0 -1
1 240 288 16 16 0 -1
1 208 272 48 32 0 -1
1 256 288 256 48 0 -1
1 256 240 256 48 0 -1
1 256 192 96 80 0 -1
1 416 192 96 80 0 -1
1 512 160 64 48 0 -1
1 416 400 32 32 0 -1
1 416 368 96 16 0 -1
1 0 48 864 16 0 -1
1 944 48 80 16 0 -1
1 0 32 1024 24 0 -1
3 160 848 64 8 0 -1
3 464 880 32 8 0 -1
3 928 848 64 8 0 -1
3 848 592 32 8 0 -1
3 912 592 32 8 0 -1
3 352 160 64 8 0 -1
3 80 352 32 8 0 -1
3 160 368 64 8 0 -1
3 64 432 96 8 0 -1
7 784 528 224 16 0 -1