34
11 24 320 16 16 0 4
11 72 224 16 16 0 6
11 200 80 16 16 0 2
11 384 128 16 16 0 0
11 672 80 16 16 0 2
11 464 320 16 16 0 3
11 528 192 16 16 0 1
11 216 432 16 16 0 2
11 136 808 16 16 0 3
11 528 872 16 16 0 2
11 448 904 16 16 0 1
11 984 416 16 16 0 1
11 984 320 16 16 0 2
11 1000 640 16 16 0 5
11 920 808 16 16 0 2
11 872 904 16 16 0 1
11 208 8 104 8 0 1
12 137 625 0 0 0 0
13 560 275 0 0 0 0
13 650 390 0 0 0 1
13 650 540 0 0 0 2
14 272 88 16 40 0 2
14 96 912 16 40 0 1
14 232 800 24 40 0 1
14 344 800 24 40 0 -1
15 128 224 16 32 0 -1
15 624 920 24 40 0 -1
16 408 96 24 48 0 -1
17 368 88 16 16 0 -1
17 368 72 16 16 0 -1
17 560 200 16 16 0 -1
17 240 424 16 16 0 -1
18 888 640 24 16 0 -1
19 792 720 24 24 0 -1