90 64 59
0 1 1 1 1 1 1 1 0 1 1 1 1 1 1 1 0 1 1 1 2 3 2 3 0 1 1 1 1 1 1 1 0 1 1 1 1 1 1 1 0 1 1 1 1 1 1 1 0 1 1 1 1 1 1 1 0 1 1 1 1 1 1 1
4 5 5 5 5 6 7 5 8 7 5 5 5 5 6 5 8 5 5 5 9 10 9 10 8 7 5 5 6 7 6 5 8 5 5 5 11 5 5 6 8 7 5 5 5 5 6 5 8 5 5 5 5 6 7 5 8 7 5 5 5 5 6 5
8 7 5 5 6 5 5 7 4 5 7 6 7 6 5 5 4 12 5 5 13 14 13 14 4 5 7 6 5 5 5 5 4 7 5 5 6 5 6 5 15 5 7 6 7 6 5 5 8 7 5 5 6 5 5 7 4 5 7 6 7 6 5 5
4 5 7 6 5 5 5 5 4 5 5 5 5 5 5 5 4 5 7 6 9 10 9 10 4 5 5 5 5 5 5 5 4 5 7 6 5 5 16 5 8 5 5 5 5 5 5 5 4 5 7 6 5 5 5 5 4 5 5 5 5 5 5 5
4 5 5 5 5 17 18 19 4 5 5 5 5 5 5 5 4 5 17 18 20 21 20 21 8 5 5 5 5 22 23 5 8 5 5 5 5 5 5 7 4 5 5 5 5 5 5 5 4 5 5 5 5 17 18 19 4 5 5 5 5 5 5 5
4 24 24 24 24 25 26 27 8 24 24 24 24 24 24 24 8 5 5 5 5 5 5 5 8 5 5 5 5 5 5 5 8 24 24 24 24 24 24 24 8 24 24 24 24 24 24 24 4 24 24 24 24 25 26 27 8 24 24 24 24 24 24 28
8 5 5 5 5 7 5 5 8 5 22 29 29 23 5 30 8 24 24 24 24 24 24 24 8 24 24 24 24 24 24 24 17 31 18 18 19 18 18 19 8 5 32 33 32 33 5 30 8 5 5 5 5 7 5 5 8 5 22 29 29 23 5 34
8 5 5 5 5 5 7 6 8 5 5 5 5 5 30 5 4 5 5 5 5 5 5 5 4 5 5 5 5 5 30 5 35 5 5 5 5 5 5 5 8 5 5 5 5 5 30 5 8 5 5 5 5 5 7 6 8 5 5 5 5 5 30 5
4 5 5 5 5 5 5 30 8 5 5 5 5 5 36 5 4 5 5 5 5 5 5 5 4 5 5 5 5 5 7 5 4 5 5 37 38 5 5 30 8 5 5 5 5 5 7 5 4 5 5 5 5 5 5 30 8 5 5 5 5 5 7 5
0 5 5 5 5 5 5 7 4 5 5 5 5 5 5 7 2 3 2 3 5 5 5 2 3 5 5 2 3 5 5 7 0 5 5 39 40 5 5 7 0 5 5 5 5 5 5 7 0 5 5 5 5 5 5 7 4 5 5 5 5 5 5 7
0 24 24 24 24 24 24 24 8 24 24 24 24 24 41 5 9 10 9 10 24 24 24 9 10 24 24 9 10 24 24 24 0 24 24 42 43 24 24 24 0 24 24 24 24 24 24 24 0 24 24 24 24 24 24 24 8 24 24 24 24 24 24 28
17 31 18 19 5 5 5 5 8 5 5 5 5 17 19 19 44 21 20 21 18 18 18 20 21 18 18 20 21 18 18 19 17 18 45 18 18 45 18 18 31 18 18 18 31 18 18 19 17 31 18 19 5 5 5 5 8 5 5 5 5 17 31 19
46 47 47 48 32 33 5 5 0 5 5 32 33 46 47 48 46 47 47 47 47 47 47 47 47 47 47 47 47 47 47 48 46 47 47 47 47 47 47 47 47 47 47 47 47 47 47 48 46 47 47 48 32 33 5 5 0 5 5 32 33 46 47 48
25 26 26 27 5 5 5 5 0 5 5 5 5 25 26 27 25 26 26 26 26 26 26 26 26 26 26 26 26 26 26 27 25 26 26 26 26 26 26 26 26 26 26 26 26 26 26 27 25 26 26 27 5 5 5 5 0 5 5 5 5 25 26 27
0 49 49 49 49 49 49 49 0 49 49 49 49 49 49 49 50 18 18 18 18 18 18 18 18 18 18 18 18 31 18 51 52 49 49 49 49 49 49 49 0 49 49 49 49 49 49 49 0 49 49 49 49 49 49 49 0 49 49 49 49 49 49 49
0 1 1 1 1 1 1 1 0 1 1 1 1 1 1 1 53 47 47 47 47 47 47 47 47 47 47 47 47 47 47 54 0 1 1 1 1 1 1 1 0 1 1 1 1 1 1 1 0 1 1 1 1 1 1 1 0 1 1 1 1 1 1 1
8 5 5 5 5 5 5 5 8 7 5 5 5 5 6 5 55 56 56 56 56 56 56 56 56 56 56 56 56 56 56 57 8 5 5 5 5 5 5 5 8 7 5 5 5 5 6 5 8 6 7 5 5 5 5 5 8 7 5 5 5 5 6 5
8 7 5 5 6 7 5 5 8 5 7 6 7 6 5 5 55 56 56 56 56 56 56 56 56 56 56 56 56 56 56 57 8 7 5 5 6 7 5 5 8 5 7 6 7 6 5 5 4 5 5 7 6 7 5 5 4 5 7 6 7 6 5 5
4 5 7 6 5 5 7 5 4 5 5 5 5 5 5 5 46 47 47 47 47 47 47 47 47 47 47 47 47 47 47 48 4 5 7 6 5 5 7 5 4 5 5 5 5 5 5 5 4 5 5 5 5 5 32 33 32 33 5 5 5 5 5 5
4 5 5 5 5 5 5 7 8 5 5 5 5 5 5 5 55 56 56 56 56 56 56 56 56 56 56 56 56 56 56 57 4 5 5 5 5 5 5 7 8 5 5 5 5 5 5 5 8 5 5 5 5 5 5 5 5 5 5 5 5 5 5 5
4 24 24 24 24 24 24 24 8 24 24 24 24 24 24 24 55 56 56 56 56 56 56 56 56 56 56 56 56 56 56 57 4 24 24 24 24 24 24 24 8 24 24 24 24 24 24 24 8 24 24 24 24 24 24 24 4 24 24 24 24 24 24 28
8 5 5 5 5 5 5 7 8 5 5 5 5 5 5 30 55 56 56 56 56 56 56 56 56 56 56 56 56 56 56 57 8 5 5 5 5 5 5 7 8 5 5 5 5 5 5 30 8 58 59 60 5 5 5 7 4 5 5 5 58 59 60 5
8 5 5 5 5 5 5 5 8 5 5 5 5 5 30 5 55 56 56 56 56 56 56 56 56 56 56 56 56 56 56 57 8 5 5 5 5 5 5 5 8 5 5 5 5 5 30 5 8 5 5 5 5 22 23 5 4 22 23 5 5 5 5 5
4 5 5 5 5 5 5 30 4 5 5 5 5 5 7 5 55 56 56 56 56 56 56 56 56 56 56 56 56 56 56 57 4 5 5 5 5 5 5 5 4 5 5 5 5 5 7 5 4 5 5 5 5 5 5 5 8 5 5 5 5 5 5 5
8 5 5 5 5 5 5 7 4 5 5 5 5 5 5 7 46 47 47 47 47 47 47 47 47 47 47 47 47 47 47 48 8 5 5 5 5 5 5 61 4 5 5 5 5 5 5 7 0 5 5 5 5 5 5 5 4 5 5 5 5 5 5 5
8 24 24 24 24 24 24 24 8 24 24 24 24 24 24 24 55 56 56 56 56 56 56 56 56 56 56 56 56 56 56 57 8 24 24 24 24 24 24 5 62 5 24 24 24 24 24 24 0 24 24 24 24 24 24 24 0 24 24 24 24 24 24 28
4 6 5 5 5 5 5 5 8 5 5 5 5 5 5 7 55 56 56 56 56 56 56 56 56 56 56 56 56 56 56 57 4 6 5 5 5 5 5 5 62 5 5 5 5 5 5 7 17 63 64 64 64 64 64 64 64 64 64 64 64 64 65 19
0 5 5 5 5 5 5 5 0 5 5 5 5 5 5 5 55 56 56 56 56 56 56 56 56 56 56 56 56 56 56 57 0 5 5 5 5 5 5 5 0 5 5 5 5 5 5 5 46 47 47 47 48 47 47 47 47 46 47 47 47 47 47 48
0 5 5 5 5 5 5 5 0 5 5 5 5 5 5 5 25 26 26 26 26 26 26 26 26 26 26 26 26 26 26 27 0 5 5 5 5 5 5 5 0 5 5 5 5 5 5 5 25 26 26 26 27 26 26 26 26 25 26 26 26 26 26 27
17 18 18 31 49 49 49 49 0 49 49 49 49 49 49 49 0 49 49 49 49 49 49 49 0 49 49 49 49 49 49 49 0 49 49 49 49 49 49 49 0 49 49 49 49 49 49 49 0 49 49 49 49 49 49 49 0 49 49 49 49 49 49 49
46 47 47 48 1 1 1 1 0 1 1 1 1 1 1 1 0 1 1 1 1 1 1 1 0 1 1 1 1 1 1 1 0 1 1 1 1 1 1 1 0 1 1 1 1 1 1 1 0 1 1 1 1 1 1 1 0 1 1 1 1 1 1 1
55 56 56 57 5 5 5 5 8 7 5 5 5 11 5 5 8 5 5 5 5 5 5 5 8 7 5 5 5 5 6 5 8 5 5 5 5 5 5 5 8 7 5 5 5 5 6 5 8 5 5 5 5 5 5 5 8 5 6 7 5 5 6 5
55 56 56 57 22 29 29 29 29 23 7 6 7 6 5 5 4 7 5 5 6 7 5 6 4 5 7 6 7 6 5 5 8 7 5 5 6 7 5 5 8 5 7 6 7 6 5 5 4 7 5 5 6 7 5 5 4 6 5 5 7 6 5 5
46 47 47 48 5 5 5 5 35 5 5 5 5 5 5 5 4 5 7 6 5 32 33 5 4 5 5 5 5 5 5 5 4 5 7 6 5 5 7 5 8 5 5 5 5 5 5 5 4 5 7 6 5 5 7 6 4 5 5 5 5 5 5 5
55 56 56 57 5 5 5 30 8 5 5 5 5 5 17 19 8 5 5 5 5 5 5 5 8 24 17 19 24 24 24 24 4 5 5 5 5 5 5 7 62 5 5 5 5 5 5 5 4 24 17 19 24 24 24 17 19 24 24 24 17 19 24 28
55 56 56 57 24 24 30 5 8 24 24 24 24 24 46 48 0 5 5 5 5 5 5 5 4 5 46 48 5 5 5 5 4 24 24 24 24 24 24 24 8 24 24 24 24 24 24 24 8 5 46 48 5 5 5 46 48 5 5 5 46 48 5 5
25 26 26 27 5 5 5 5 8 5 22 29 29 23 25 27 17 18 19 24 24 24 24 24 4 24 25 26 17 18 18 19 8 5 5 5 5 5 5 7 8 5 5 5 5 5 5 30 17 31 25 27 17 18 19 25 27 17 18 19 25 27 18 19
35 5 5 5 5 22 23 5 4 5 5 5 5 5 5 5 46 47 48 5 5 5 5 30 8 5 5 5 5 5 5 5 8 5 5 5 5 5 5 5 8 5 5 5 5 5 30 5 35 5 5 5 5 5 5 5 35 5 5 5 5 5 5 5
8 5 5 5 5 5 5 30 4 5 5 5 5 5 5 30 55 56 57 24 30 11 30 5 4 11 24 24 66 5 67 24 4 5 5 5 5 5 5 30 4 5 5 5 5 5 7 5 4 5 5 37 38 5 5 30 4 11 30 11 5 5 5 5
4 5 5 5 5 5 5 7 8 5 5 5 5 5 30 5 55 56 57 30 5 5 5 5 4 6 5 5 5 5 5 30 8 5 5 5 5 5 5 7 4 5 5 5 5 5 5 7 0 5 5 39 40 5 5 7 0 5 5 5 11 5 5 5
8 24 24 24 24 24 24 24 8 24 24 24 24 30 5 5 55 56 57 5 5 5 5 5 0 24 24 24 24 24 30 5 8 24 24 24 24 24 24 24 8 24 24 24 24 24 24 24 0 24 24 42 43 24 24 24 0 5 5 5 5 11 24 28
17 19 5 5 5 5 5 5 4 5 5 5 5 5 5 17 55 56 57 17 18 31 18 68 69 18 31 18 18 68 69 19 4 6 5 5 5 5 5 5 8 5 5 5 5 5 5 7 17 18 45 18 18 45 18 18 31 18 18 18 18 31 18 19
46 47 17 19 5 5 5 5 0 5 5 5 5 17 19 48 46 47 47 47 47 47 47 47 47 47 47 47 47 47 47 48 0 5 5 5 5 5 5 5 0 5 5 5 5 5 5 5 46 47 47 47 47 47 47 47 47 47 47 47 47 47 47 48
25 26 26 27 5 5 5 5 0 5 5 5 5 25 26 27 25 26 26 26 26 26 26 26 26 26 26 26 26 26 26 27 0 5 5 5 5 5 5 5 0 5 5 5 5 5 5 5 25 26 26 26 26 26 26 26 26 26 26 26 26 26 26 70
0 49 49 49 49 49 49 49 0 49 49 49 49 49 49 49 17 18 18 18 18 18 18 18 18 18 18 18 18 18 18 19 0 49 49 49 49 49 49 49 0 49 49 49 49 49 49 49 17 18 18 31 18 18 71 72 72 72 73 18 31 18 18 19
0 5 5 11 5 5 30 5 0 5 5 5 5 5 5 6 46 47 47 47 47 47 47 47 47 47 47 47 47 47 47 48 0 1 1 1 1 1 1 1 0 1 1 1 1 1 1 1 0 1 1 1 1 1 46 47 47 47 48 1 1 1 74 75
8 5 5 5 11 30 5 5 8 7 5 5 5 5 6 5 25 26 26 26 26 26 26 26 26 26 26 26 26 26 26 27 8 6 7 5 5 5 5 5 4 7 5 5 5 5 6 5 4 5 5 5 5 5 46 47 47 47 48 5 5 5 76 77
4 7 5 5 6 7 5 5 8 5 7 6 7 6 5 5 55 56 56 56 56 57 5 5 5 5 55 56 56 56 56 57 8 5 5 7 6 7 5 5 4 5 7 6 7 6 5 5 8 7 5 5 6 7 46 47 47 47 48 6 7 6 74 78
8 5 7 6 5 5 7 5 4 5 5 5 5 5 5 5 55 56 56 56 56 57 7 5 6 7 55 56 56 56 56 57 8 5 5 5 5 5 17 18 18 18 19 5 5 5 5 5 8 5 7 6 5 5 46 47 47 47 48 5 5 5 76 77
8 5 5 5 5 5 5 7 8 5 5 5 5 5 5 5 55 56 56 56 56 57 22 29 29 23 55 56 56 56 56 57 17 18 18 19 5 5 25 26 26 26 27 5 5 5 5 5 4 24 24 24 24 24 46 47 47 47 48 24 24 24 74 75
8 24 24 24 24 24 24 24 8 24 24 24 24 24 24 24 55 56 56 56 56 57 5 5 5 5 55 56 56 56 56 57 46 47 47 48 5 5 5 5 35 5 5 5 5 5 5 5 8 24 17 19 24 24 46 47 47 47 48 24 24 24 76 77
4 5 5 5 5 5 5 7 8 5 5 5 5 5 5 30 25 26 26 26 26 27 5 5 5 5 25 26 26 26 26 27 25 26 26 27 24 24 24 24 8 24 24 24 24 17 18 19 4 5 46 48 5 5 46 47 47 47 48 5 5 5 74 78
4 5 5 5 5 5 5 5 8 5 5 5 5 5 30 5 35 5 5 5 5 5 11 5 5 5 5 5 5 5 5 5 35 5 5 5 5 5 5 7 4 5 5 5 5 5 5 5 4 5 46 48 5 5 25 26 26 26 27 5 5 30 76 77
8 5 5 5 5 5 5 30 4 5 5 5 5 5 7 5 4 5 5 5 5 5 6 5 30 11 5 5 5 5 5 5 4 5 5 5 5 5 5 5 8 5 5 5 5 5 5 30 4 5 46 48 5 5 5 5 35 5 5 11 30 5 79 80
0 5 5 5 5 5 5 7 0 5 5 5 5 5 5 7 0 5 5 5 5 6 5 30 5 5 11 5 5 5 5 30 0 5 5 5 5 5 5 5 0 5 5 5 5 5 30 5 0 5 46 48 5 81 82 5 0 5 5 5 5 5 83 84
0 24 24 24 24 24 24 24 0 24 24 24 24 24 24 24 0 5 5 5 5 11 30 5 5 5 5 11 24 24 30 5 0 24 24 24 24 24 24 24 0 24 24 24 24 30 5 5 0 24 46 48 24 24 5 24 0 7 5 5 5 5 83 84
17 18 18 31 18 18 18 18 31 18 18 68 69 31 18 19 17 18 18 18 18 18 18 18 18 18 18 18 18 18 18 19 17 18 18 18 18 18 18 18 18 18 18 68 69 18 18 19 17 18 46 48 18 31 45 45 45 45 45 18 18 18 18 19
46 47 47 47 47 47 47 47 47 47 47 47 47 47 47 48 46 47 47 47 47 47 47 47 47 47 47 47 47 47 47 48 46 47 47 47 47 47 47 47 47 47 47 47 47 47 47 48 46 47 47 47 47 47 47 48 47 47 47 47 47 47 47 48
85 86 86 86 86 86 86 86 86 86 86 86 86 86 86 87 88 86 86 86 86 86 86 86 86 86 86 86 86 86 86 87 88 86 86 86 86 86 86 86 86 86 86 86 86 86 86 87 88 86 86 86 86 86 86 89 86 86 86 86 86 86 86 87
