205 128 30
0 0 0 0 0 0 0 0 0 0 0 0 0 0 0 0 0 0 0 0 0 0 0 0 0 0 0 0 0 0 0 0 0 0 0 0 0 0 0 0 0 0 0 0 0 0 0 0 0 0 0 0 0 0 0 0 0 0 0 0 0 0 0 0 0 0 0 0 0 0 0 0 0 0 0 0 0 0 0 0 0 0 0 0 0 0 0 0 0 0 0 0 0 0 0 0 0 0 0 0 0 0 0 0 0 0 0 0 0 0 0 0 0 0 0 0 0 0 0 0 0 0 0 0 0 0 0 0
0 0 0 0 0 0 0 0 0 0 0 0 0 0 0 0 0 0 0 0 0 0 0 0 0 0 0 0 0 0 0 0 0 0 0 0 0 0 0 0 0 0 0 0 0 0 0 0 0 0 0 0 0 0 0 0 0 0 0 0 0 0 0 0 0 0 0 0 0 0 0 0 0 0 0 0 0 0 0 0 0 0 0 0 0 0 0 0 0 0 0 0 0 0 0 0 0 0 0 0 0 0 0 0 0 0 0 0 0 0 0 0 0 0 0 0 0 0 0 0 0 0 0 0 0 0 0 0
0 0 0 0 0 0 0 0 0 0 0 0 0 0 0 0 0 0 0 0 0 0 0 0 0 0 0 0 0 0 0 0 0 0 0 0 0 0 0 0 0 0 0 0 0 0 0 0 0 0 0 0 0 0 0 0 0 0 0 0 0 0 0 0 0 0 0 0 0 0 0 0 0 0 0 0 0 0 0 0 0 0 0 0 0 0 0 0 0 0 0 0 0 0 0 0 0 0 0 0 0 0 0 0 0 0 0 0 0 0 0 0 0 0 0 0 0 0 0 0 0 0 0 0 0 0 0 0
0 0 0 0 0 0 1 2 3 0 0 0 0 0 0 0 0 0 0 0 0 0 4 5 5 0 0 0 0 0 0 0 0 0 0 0 0 0 1 2 3 0 0 0 0 0 0 0 0 0 0 0 0 0 1 2 3 0 0 0 0 0 0 0 0 0 0 0 0 0 1 2 3 0 0 0 0 0 0 0 0 0 0 0 0 0 1 2 3 0 0 0 0 0 0 0 0 0 0 0 0 0 1 2 3 0 0 0 0 0 0 0 0 0 0 0 0 0 0 0 0 0 0 0 0 0 0 0
0 0 0 0 0 0 6 7 7 0 0 0 0 0 0 0 0 0 0 0 0 0 6 7 7 0 0 0 0 0 0 0 0 0 0 0 0 0 6 7 7 0 0 0 0 0 0 0 0 0 0 0 0 0 6 7 7 0 0 0 0 0 0 0 0 0 0 0 0 0 6 7 7 0 0 0 0 0 0 0 0 0 0 0 0 0 6 7 7 0 0 0 0 0 0 0 0 0 0 0 0 0 6 7 7 0 0 0 0 0 0 0 0 0 0 0 0 0 0 0 0 0 0 0 0 0 0 0
0 0 0 0 0 0 8 9 9 0 0 0 0 0 0 0 0 0 0 0 0 0 8 9 9 0 0 0 0 0 0 0 0 0 0 0 0 0 8 9 9 0 0 0 0 0 0 0 0 0 0 0 0 0 8 9 9 0 0 0 0 0 0 0 0 0 0 0 0 0 8 9 9 0 0 0 0 0 0 0 0 0 0 0 0 0 8 9 9 0 0 0 0 0 0 0 0 0 0 0 0 0 8 9 9 0 0 0 0 0 0 0 0 0 0 0 0 0 0 0 0 0 0 0 0 0 0 0
0 0 0 0 0 0 8 9 9 0 0 0 0 0 0 0 0 0 0 0 0 0 8 9 9 0 0 0 0 0 0 0 0 0 0 0 0 0 8 9 9 0 0 0 0 0 0 0 0 0 0 0 0 0 8 9 9 0 0 0 0 0 0 0 0 0 0 0 0 0 8 9 9 0 0 0 0 0 0 0 0 0 0 0 0 0 8 9 9 0 0 0 0 0 0 0 0 0 0 0 0 0 8 9 9 0 0 0 0 0 0 0 0 0 0 0 0 0 0 0 0 0 0 0 0 0 0 0
0 0 0 0 10 11 12 9 9 0 0 0 0 0 0 0 0 0 0 0 10 11 12 9 9 0 0 0 0 0 0 0 0 0 0 0 10 11 12 9 9 0 0 0 0 0 0 0 0 0 0 0 10 11 12 9 9 0 0 0 0 0 0 0 0 0 0 0 10 11 12 9 9 0 0 0 0 0 0 0 0 0 0 0 10 11 12 9 9 0 0 0 0 0 0 0 0 0 0 0 10 11 12 9 9 0 0 0 0 0 0 0 0 0 0 0 0 0 0 0 0 0 0 0 0 0 0 0
0 0 0 0 13 14 14 9 9 0 0 0 1 2 0 0 0 0 0 0 13 14 14 9 9 0 0 0 1 2 0 0 0 0 0 0 13 14 14 9 9 0 0 0 1 2 0 0 0 0 0 0 13 14 14 9 9 0 0 0 1 2 0 0 0 0 0 0 13 14 14 9 9 0 0 0 1 2 0 0 0 0 0 0 13 14 14 9 9 0 0 0 1 2 0 0 0 0 0 0 13 14 14 9 9 0 0 0 1 2 0 0 0 0 0 0 0 0 0 0 0 0 0 0 0 0 0 0
0 0 0 0 15 16 16 9 9 0 0 0 6 7 0 0 0 0 0 0 15 16 16 9 9 0 0 0 6 7 0 0 0 0 0 0 15 16 16 9 9 0 0 0 6 7 0 0 0 0 0 0 15 16 16 9 9 0 0 0 6 7 0 0 0 0 0 0 15 16 16 9 9 0 0 0 6 7 0 0 0 0 0 0 15 16 16 9 9 0 0 0 6 7 0 0 0 0 0 0 15 16 16 9 9 0 0 0 6 7 0 0 0 0 0 0 0 0 0 0 0 0 0 0 0 0 0 0
0 0 0 0 15 16 16 9 17 18 0 0 8 17 18 0 0 0 0 0 15 16 16 9 17 18 0 0 8 17 18 0 0 0 0 0 15 16 16 9 17 18 0 0 8 17 18 0 0 0 0 0 15 16 16 9 17 18 0 0 8 17 18 0 0 0 0 0 15 16 16 9 17 18 0 0 8 17 18 0 0 0 0 0 15 16 16 9 17 18 0 0 8 17 18 0 0 0 0 0 15 16 16 9 17 18 0 0 8 17 18 0 0 0 0 0 0 0 0 0 0 0 0 0 0 0 0 0
0 0 0 0 15 16 16 9 13 14 0 1 8 13 14 0 0 0 0 0 15 16 16 9 13 14 0 1 8 13 14 0 0 0 0 0 15 16 16 9 13 14 0 1 8 13 14 0 0 0 0 0 15 16 16 9 13 14 0 1 8 13 14 0 0 0 0 0 15 16 16 9 13 14 0 1 8 13 14 0 0 0 0 0 15 16 16 9 13 14 0 1 8 13 14 0 0 0 0 0 15 16 16 9 13 14 0 1 8 13 14 0 0 0 0 0 0 0 0 0 0 0 0 0 0 0 0 0
0 0 19 20 21 22 22 23 21 22 20 24 25 21 22 26 0 0 19 20 21 22 22 23 21 22 20 24 25 21 22 26 0 0 19 20 21 22 22 23 21 22 20 24 25 21 22 26 0 0 19 20 21 22 22 23 21 22 20 24 25 21 22 26 0 0 19 20 21 22 22 23 21 22 20 24 25 21 22 26 0 0 19 20 21 22 22 23 21 22 20 24 25 21 22 26 0 0 19 20 21 22 22 23 21 22 20 24 25 21 22 26 0 0 0 0 0 0 0 0 0 0 0 0 0 0 0 0
0 0 27 28 28 28 28 28 28 28 28 28 28 28 28 29 0 0 27 28 28 28 28 28 28 28 28 28 28 28 28 29 0 0 27 28 28 28 28 28 28 28 28 28 28 28 28 29 0 0 27 28 28 28 28 28 28 28 28 28 28 28 28 29 0 0 27 28 28 28 28 28 28 28 28 28 28 28 28 29 0 0 27 28 28 28 28 28 28 28 28 28 28 28 28 29 0 0 27 28 28 28 28 28 28 28 28 28 28 28 28 29 0 0 0 0 0 0 0 0 0 0 0 0 0 0 0 0
0 0 30 31 31 31 31 31 31 31 31 31 31 31 31 31 0 0 30 31 31 31 31 31 31 31 31 31 31 31 31 31 0 0 30 31 31 31 31 31 31 31 31 31 31 31 31 31 0 0 30 31 31 31 31 31 31 31 31 31 31 31 31 31 0 0 30 31 31 31 31 31 31 31 31 31 31 31 31 31 0 0 30 31 31 31 31 31 31 31 31 31 31 31 31 31 0 0 30 31 31 31 31 31 31 31 31 31 31 31 31 31 0 0 0 0 0 0 0 0 0 0 0 0 0 0 0 0
0 0 30 32 32 32 32 32 32 32 32 32 32 32 32 32 0 0 30 33 33 33 33 33 33 33 33 33 33 33 33 33 0 0 30 34 34 34 34 34 34 34 34 34 34 34 34 34 0 0 30 34 34 34 34 34 34 34 34 34 34 34 34 34 0 0 30 33 33 33 33 33 33 33 33 33 33 33 33 33 0 0 30 32 32 32 32 32 32 32 32 32 32 32 32 32 0 0 30 33 33 33 33 33 33 33 33 33 33 33 33 33 0 0 0 0 0 0 0 0 0 0 0 0 0 0 0 0
0 0 30 31 35 31 35 31 35 31 31 36 37 36 37 31 0 0 30 38 38 39 40 38 39 40 38 39 40 38 41 42 0 0 30 43 43 44 43 43 43 43 44 43 44 43 44 43 0 0 30 43 43 44 43 43 43 43 44 43 44 43 44 43 0 0 30 38 38 39 40 38 39 40 38 39 40 38 41 42 0 0 30 31 35 31 35 31 35 31 31 36 37 36 37 31 0 0 30 38 38 39 40 38 39 40 38 39 40 38 41 42 0 0 10 18 0 0 0 0 0 0 0 45 10 18 0 0
0 0 30 31 46 31 46 31 46 31 31 47 48 47 48 31 0 0 30 38 38 49 50 38 49 50 38 49 50 38 46 51 0 0 30 43 43 46 43 52 53 43 46 43 46 43 46 43 0 0 30 43 43 46 43 52 53 43 46 43 46 43 46 43 0 0 30 38 38 49 50 38 49 50 38 49 50 38 46 51 0 0 30 31 46 31 46 31 46 31 31 47 48 47 48 31 0 0 30 38 38 49 50 38 49 50 38 49 50 38 46 51 0 0 13 14 0 0 0 1 2 0 0 6 13 14 0 0
0 0 30 31 46 31 46 31 46 31 31 49 50 49 50 31 0 0 30 38 38 54 55 38 54 55 38 54 55 38 56 51 0 57 58 43 43 59 43 60 61 43 59 43 59 43 59 43 0 10 58 43 43 59 43 60 61 43 59 43 59 43 59 43 0 0 30 38 38 54 55 38 54 55 38 54 55 38 56 51 0 0 30 31 46 31 46 31 46 31 31 49 50 49 50 31 0 0 30 38 38 54 55 38 54 55 38 54 55 38 56 51 0 0 15 16 0 0 10 62 7 10 0 8 63 64 3 0
0 0 58 65 66 67 68 31 68 31 31 69 70 69 70 31 0 0 58 71 71 71 71 71 71 71 71 71 71 71 71 72 0 13 73 74 74 74 74 74 74 74 74 74 74 74 74 74 0 13 73 74 74 74 74 74 74 74 74 74 74 74 74 74 0 0 58 71 71 71 71 71 71 71 71 71 71 71 71 72 0 0 58 65 66 67 68 31 68 31 31 69 70 69 70 31 0 0 58 71 71 71 71 71 71 71 71 71 71 71 71 72 75 75 76 77 75 75 78 79 80 78 75 81 82 83 83 75
0 0 73 84 85 86 87 87 87 87 87 87 87 87 87 87 1 3 73 88 88 88 89 90 91 88 88 88 88 88 88 88 0 15 92 93 93 93 93 93 93 93 93 93 93 93 93 93 0 15 94 93 93 93 93 93 93 93 93 93 93 93 93 93 1 3 73 88 88 88 89 90 91 88 88 88 88 88 88 88 0 0 73 84 85 86 87 87 87 87 87 87 87 87 87 87 1 3 73 88 88 88 89 90 91 88 88 88 88 88 88 88 95 96 95 96 95 96 95 96 95 96 95 96 95 96 95 96
0 0 94 97 97 97 97 97 97 97 97 97 97 97 97 97 6 7 94 38 41 38 98 99 100 38 41 38 41 38 41 42 0 15 94 43 43 43 43 43 43 43 43 43 43 43 43 43 0 15 94 43 43 43 43 43 43 43 43 43 43 43 43 43 6 7 94 38 41 38 98 99 100 38 41 38 41 38 41 42 0 0 94 97 97 97 97 97 97 97 97 97 97 97 97 97 6 7 94 38 41 38 98 99 100 38 41 38 41 38 41 42 101 102 101 102 101 102 101 102 101 102 101 102 101 102 103 104
0 0 94 31 35 31 35 31 35 31 31 36 37 36 37 31 8 9 94 38 46 38 47 105 48 38 46 38 46 38 46 51 0 15 94 43 52 53 43 43 44 43 52 106 107 43 44 43 0 15 94 43 52 53 43 43 44 43 52 106 107 43 44 43 8 9 94 38 46 38 47 105 48 38 46 38 46 38 46 51 0 0 94 31 35 31 35 31 35 31 31 36 37 36 37 31 8 9 94 38 46 38 47 105 48 38 46 38 46 38 46 51 108 109 108 109 108 109 108 109 108 109 108 109 108 109 103 110
0 0 94 31 46 31 46 31 46 31 31 47 48 47 48 31 8 17 94 38 46 38 47 105 48 38 46 38 46 38 46 51 45 15 94 43 60 61 43 43 46 43 111 112 113 43 46 43 45 15 94 43 60 61 43 43 46 43 111 112 113 43 46 43 8 17 94 38 46 38 47 105 48 38 46 38 46 38 46 51 0 0 94 31 46 31 46 31 46 31 31 47 48 47 48 31 8 17 94 38 46 38 47 105 48 38 46 38 46 38 46 51 114 115 114 115 114 115 114 115 114 115 114 115 114 115 103 104
116 116 94 31 46 31 46 31 46 31 31 49 50 49 50 31 8 13 94 38 59 38 49 117 50 38 56 38 56 38 56 51 6 15 94 43 43 43 43 43 59 43 47 105 48 43 59 43 6 15 94 43 43 43 43 43 59 43 47 105 48 43 59 43 8 13 94 38 118 38 49 117 50 38 56 38 56 38 56 51 116 116 94 31 46 31 46 31 46 31 31 49 50 49 50 31 8 13 94 38 118 38 49 117 50 38 56 38 56 38 56 51 119 120 119 120 119 120 119 120 119 120 119 120 119 120 103 110
119 119 94 31 68 31 68 31 68 31 31 69 70 69 70 31 8 15 94 121 122 121 123 124 70 125 121 121 121 121 121 126 8 15 94 122 122 122 122 122 122 122 49 117 50 122 122 122 8 15 94 122 122 122 122 122 122 122 49 117 50 122 122 122 8 15 94 121 127 121 123 124 128 121 121 121 121 121 121 126 119 119 94 31 68 31 68 31 68 31 31 69 70 69 70 31 8 15 94 121 127 121 123 124 128 121 121 121 121 121 121 126 119 119 119 119 119 129 119 129 119 129 119 129 119 129 103 104
130 130 131 132 132 132 132 132 132 132 132 132 132 132 132 132 133 134 131 135 135 135 136 137 138 135 135 135 135 135 135 135 133 134 131 135 135 135 135 135 135 135 123 124 128 135 135 139 133 134 131 135 135 135 135 135 135 135 123 124 128 135 135 135 133 134 131 135 135 135 140 137 141 135 135 135 135 135 135 135 130 130 131 132 132 132 132 132 132 132 132 132 132 132 132 132 133 134 131 135 135 135 140 137 141 135 135 135 135 135 135 135 142 142 142 143 119 120 119 120 119 120 119 120 119 120 103 110
144 144 144 144 144 145 146 147 146 147 148 144 144 144 144 144 144 144 144 144 144 144 149 149 150 144 144 144 144 144 144 144 144 144 144 144 144 144 144 144 144 144 151 149 152 144 144 144 144 144 144 144 144 144 144 144 144 144 151 149 152 144 144 144 144 144 144 144 144 144 151 149 152 144 144 144 144 144 144 144 144 144 144 144 144 145 146 147 146 147 148 144 144 144 144 144 144 144 144 144 144 144 151 149 152 144 144 144 144 144 144 144 95 96 95 110 153 154 155 154 154 154 154 154 154 154 103 156
157 157 158 157 157 159 160 161 162 163 164 158 158 158 158 158 158 158 158 158 165 158 158 166 157 157 157 157 157 157 167 158 168 169 158 158 158 158 170 157 157 171 158 158 158 158 165 172 172 172 172 172 172 172 172 172 172 173 158 158 158 158 174 157 157 157 157 175 158 158 158 158 158 158 158 158 174 157 157 157 157 157 157 176 158 177 178 179 178 179 164 172 172 172 172 172 157 157 157 172 172 172 180 158 158 158 158 158 158 158 158 158 101 156 181 182 183 95 110 95 96 95 96 95 96 95 103 156
184 184 185 184 184 184 184 184 186 187 187 187 187 187 187 187 187 187 187 187 188 187 187 189 184 184 184 184 184 184 190 187 191 192 187 187 187 187 193 184 184 194 187 187 187 187 195 196 196 196 196 196 196 196 196 196 196 197 187 187 187 187 198 184 184 184 184 199 187 187 187 187 187 187 187 187 198 184 184 184 184 184 184 200 187 187 187 187 187 187 187 196 196 196 196 196 201 201 201 196 196 196 202 187 187 187 187 187 187 187 187 187 102 156 203 204 102 101 102 101 102 101 102 101 102 101 101 102
